[size:40,30]
(
0000000000000000000000000000000000000000
0111111111111111111111111111111111111410
0100000100100010000010001000000100000010
0100000100100010000010001000000100000010
0100000100100010000010001000000100000010
0100000100111111111111111111111111111110
0100000111100000000010000000000001000010
0100000100100000000010000000000001000010
0100000100100000000011111111111111111110
0100000100100000000010000000000000000010
0111111111111111111320000000000000000010
0100000100000000000010000000000000000010
0100000100000000000010000000000000000010
0100000100000000000010000000000000000010
0100000100000000000010000000000000000010
0100000100000000000010000000000000000010
0100000100000000000010000000000000000010
0100000111111111111111111111111111111110
0100000100000001000000000001000000000010
0100000100000001000000000001000000000010
0100000100000001000000000001000000000010
0111111100000001000000000001000000000010
0100000100000001111111111111111111111110
0100000100000001000100000000000000000010
0100000100000001000100000000000000000010
0100000100000001000111111111111111111110
0100000100000001000100000000000010000010
0100000100000001000100000000000010000010
0111111111111111111111111111111111111110
0000000000000000000000000000000000000000
)
